WWWWWWWWWWWWWWWWWWWW
W..................W
W..P....T..........W
W......TTT......Z..W
W.......WWWW.......W
W..A....WFF........W
W.......WFF...Z....W
W.......WWWW.......W
W...M..............W
W...T.......O......W
W......W....W......W
W......W..Z.W......W
W......WWWWWW......W
W..................W
W..................W
WWWWWWWWWWWWWWWWWWWW
